{
    "levels": {
        "level1": {
            "layout": [
                [1, 1, 1, 1, 1, 1, 1, 1, 1],
                [1, 1, 1, 1, 1, 1, 1, 1, 1],
                [1, 1, 1, 1, 1, 1, 1, 1, 1],
                [1, 1, 1, 1, 1, 1, 1, 1, 1]
            ],
            "theme": "Standard"
        },
        "level2": {
            "layout": [
                [1, 0, 1, 0, 1, 0, 1, 0, 1],
                [1, 1, 1, 1, 1, 1, 1, 1, 1],
                [0, 1, 0, 1, 0, 1, 0, 1, 0],
                [1, 1, 1, 1, 1, 1, 1, 1, 1]
            ],
            "theme": "Standard"
        },
        "level3": {
            "layout": [
                [1, 1, 1, 1, 1, 0, 0, 0, 0],
                [0, 0, 1, 1, 1, 1, 1, 0, 0],
                [0, 0, 0, 0, 1, 1, 1, 1, 1],
                [1, 1, 1, 0, 0, 0, 1, 1, 1]
            ],
            "theme": "Football"
        },
        "level4": {
            "layout": [
                [1, 1, 0, 0, 1, 0, 0, 1, 1],
                [1, 0, 0, 1, 1, 1, 0, 0, 1],
                [0, 1, 1, 1, 0, 1, 1, 1, 0],
                [1, 0, 1, 0, 0, 0, 1, 0, 1]
            ],
            "theme": "Default"
        }
    }
}
